*********************************
***************X*****************
***************.*****************
***************.*****************
***************.*****************
*...............*****************
********.******.*****************
********.******.***********.....*
********.******.***********.***.*
********.******.***********.***.*
********.******.***********.*...*
********.******.***********.*.***
***@..........................***
***************.***********.*****
***************.***********.*****
***************.***********.*****
***************.***********.*****
***************.............*****
***************.***********.*****
***************.***********.*****
***************.***********.*****
***************.***********.*****
***************@............*****
*********************************