*******************************
*.............................*
*.                         ****
*.*@@@
*.*
*.*X
*.*
*.*
*.*
*.*
*.*
*.*
*.*
*.*
*.*
*.*
*.*
*.*
*.*
*.*
*.*
*.*
*.***************************.*
*.............................*
*******************************