*********************************
*......X........................*
*.************.*******.********.*
*.************.*******.********.*
*.************.*******.********.*
*.************.*******.********.*
*.****........@........********.*
*.****.*******.****************.*
*.****.*******.****************.*
*......*******.****************.*
*.****.*******....*************.*
*.****.*******.**.*************.*
*...............................*
*.*******.****.****************.*
*.*******.****.****************.*
*.*******............**********.*
*.*******.****.*****.**********.*
*.*******.****.*****............*
*......@.......*****.**********.*
*.**.*****.***.*****.**********.*
*.**.*****.***.......**********.*
*.**.*****.***.****************.*
*....................@..........*
*********************************